*************
*          O*
* ***********
* *         *
* * *********
* * *   *   *
* *   *   * *
* ********* *
*         X *
*************