********
*    O *
*  *** *
* **   *
* ** ***
*     X*
********