********************
*X                 *
*                  *
*   ****    ****   *
*   *  *    *  *   *
*   ****    ****   *
*                  *
*                  *
*        **        *
*        **        *
*                  *
*                  *
*   ****    ****   *
*   *  *    *  *   *
*   ****    ****   *
*                  *
*                  *
*                 O*
********************
