*************
*          0*
*     B     *
* *       * *
*           *
*           *
*           *
*           *
*     X     *
*************