******************
*                *
**************** *
* ******** *** * *
* *     O* *** * *
* *          * * *
* ************ * *
*              * *
************ *** *
*X               *
******************