******************************
*X                           *
*   *  *************  ****** *
* * *  *           *  *    * *
* * *  * ****** ** *  * ** * *
* * *  * *       * *  * ** * *
* * *  * * *** * * *    **   *
* * *  * * *   * * *  ********
* * *  * * *** * * *         *
* * *  * *       * *******   *
* * *  * ****** **       *   *
* * *  *                 *   *
* * *  *******************   *
* * *                        *
* * * ******************** ***
* *                          *
* *  **********************  *
* *  *                    *  *
* *  *  ****************  *  *
* *  *  *              *  *  *
* *  *  *  **********  *  *  *
* *  *  *  *        *  *  *  *
* *  *  *  *  ***** *  *  *  *
* *  *  *  *       O*  *  *  *
* *  *  *  *  *******  *  *  *
* *  *  *  *           *  *  *
* *  *  *  *************  *  *
*    *                    *  *
*                            *
******************************
