********************
*X                 *
* **************** *
* *              * *
* * * * * * * * ** *
* * * * * * * *    *
*             *    *
***************    *
              *    *
              *    *
              **-***
              *    *
              *    *
              *   O*
              ******