********************
*X                 *
*                  *
*                  *
****************  **
*                  *
* ******************
*                  *
*******-*******    *
*             *    *
*      O      *    *
****************  **
*             *    *
*  ************ ** *
*                  *
********************