*********************************************************************************************
*X                                                 *                         *              *
* ************************************************ * *********************** *              *
*                       *   *                      *                         *              *
*                       * * *                   *  **************            *              *
*                         *                     *                                           *
******************************************************************************************* *
*                     *******************************                     ***************** *
*-******************  ******************************* ******************          ****      *
* ***      *********                                  ***************************  *** **** *
* *** **** ************** *************************** *******        ************  **   *** *
* **   *** ************** *************************     ***** ***********O******        *** *
* **   ***                ************ ************           *********** ***********   *** *
* **   ***     ********** ******* ****       ******     ***************** *****************-*
* **** ***         *   ** ***          ***  *******     ***************** ***************** *
* **** ***     *** *   ** *** ********************** **********      **** ***************** *
* ****   *********   ****     ********************** *        * ** ****** ***************** *
* ************************************************** - ****** *  * ****** ***************** *
* **************************************************************** ****** ***************** *
*                                                                                           *
*********************************************************************************************
