*********************************************************************************************
*X                                                 *                         *              *
* ************************************************ * *********************** *              *
*                       *   *                      *                         *              *
*                       * * *                   *  **************            *              *
*                         *                     *                                           *
******************************************************************************************* *
*                     *******************************                     ***************** *
*-******************  ******************************* ******************          ****      *
* ***      *********                                  ***************************  *** **** *
* *** **** ************** ********************* ***** *******        ************  **   *** *
* **   *** ************** ********************* ***     ***** ***********O******        *** *
* **   ***                ************ ******** ***           *********** ***********   *** *
* **   ***     ********** ******* ****       ** ***     ***************** *****************-*
* **** ***         *   ** ***          ***  *** ***     ***************** ***************** *
* **** ***     *** *   ** *** ***************** **** **********      **** ***************** *
* ****   *********   ****     *********          *** *        * ** ****** ***************** *
* *************************************          *** - ****** *  * ****** ***************** *
* **************************************************************** ****** ***************** *
*                                                                                           *
*********************************************************************************************