********************
*************      *
**          *      *
**                 *
**                 *
**  *     **   *   *
*** *      *** **  *
*O* *        *  *  *
* * *        *  *  *
* * *        *  *  *
* * **      *   *  *
* *  **  X**    *  *
* *   *****     *  *
* *             *  *
* *             *  *
* *      ***** **  *
* *  *****    **   *
*                  *
*                  *
********************