********
*     O*
* ***********
* *         *
* ** ****** *
*     X*    *
*************