********
*     O*
*  *****
* *    *
* ** ***
*     X*
********