********
*      *
*      *
*      *
*      *
*     X*
********