********
*O     *
*      *
*      *
*      *
*     X*
********