************
*X *   *   *
*  * * * * *
** * * * * *
*    *   * *
* ******** *
* *      * *
* * **** * *
* * *  *   *
*   *  *** *
*****    O *
************
