***************
*X            *
* *********** *
* *         * *
* * ******* * *
* *       * * *
* * * *** * * *
* * * *O* * * *
* * * * * * * *
* * *     * * *
* * ******* * *
* *           *
* *********** *
*             *
***************
