***************
*X            *
* ***** * *** *
* *     * * * *
* * ***** * * *
* *       *   *
* * ********* *
* *           *
* *********** *
* *           *
* * ***********
* *           *
* *********** *
*            O*
***************
