****************
*X             *
*  *   *   *   *
*              *
*  *   *   *   *
*              *
*  *   *   *   *
*              *
*  *   *   *   *
*              *
*  *   *   *   *
*              *
*  *   *   *   *
*              *
*             O*
****************
