*****************
*X              *
*               *
*               *
*               *
*      ***      *
*      * *      *
*******   ***** *
*      * *      *
*      ***      *
*               *
*               *
*               *
*               *
*              O*
*****************
