******************
*X               *
* ************** *
* *            * *
* * ********** * *
* * *        * * *
* * * ****** * * *
* * * *    * * * *
* * * * ** * * * *
* * * *  O * * * *
* * * **** * * * *
* * *      * * * *
* * ******** * * *
* *          * * *
* ************ * *
*              * *
*                *
******************
